NO ./assets/textures/walls/brain_coral.png
SO ./assets/textures/walls/redstone_ore.png
WE ./assets/textures/walls/chiseled_tuff_top.png
EA ./assets/textures/walls/brain_coral.png
F 173,217,23
C 172,27,135
1111111111111
1000eVGV10001
1000e11011101
1a00100010N01
1000111010111
1000100000001
1q1010100d001
10100a1000001
10111110000a1
1010000010001
10111100101s1
1000000d00101
1111111111111
