NO ./assets/img/bamboo_block.png
SO ./assets/img/chiseled_tuff_top.png
WE ./assets/img/amethyst_block.png
EA ./assets/img/bricks.png
F 107,212,115
C 4,89,47
111111111111111
110000000000011
111111111111011
110000000000011
110101001011011
110101000001011
110101011001111
110101000000011
110001111111011
110101000001011
110101011101011
110101010100011
110101010111011
110100010001011
1101E1110111011
110000010000001
111100010110001
110100000100001
110100011001111
110100010000011
110111000111011
110001010000011
110111010101111
110100010100011
110101110111011
110100010100011
110111011101011
110000000001011
111111111111111
111111111111111
