NO ./assets/img/bubble_coral.png
SO ./assets/img/bubble_coral.png
WE ./assets/img/bubble_coral.png
EA ./assets/img/bubble_coral.png
F 167,192,224
C 0,32,64
111111111
101000101
100000101
100000001
100001101
100010001
101010111
1010000N1
111111111
