NO ./assets/img/cherry_planks.png
SO ./assets/img/blackstone.png
WE ./assets/img/bamboo_block.png
EA ./assets/img/amethyst_block.png

F 184,113,39
C 51,198,227

11111111111111111111111111111
10000000000000000000000000001
10000000001110000001111111101
10000000111000000111000011101
10000011101110000000001110001
10001110011100000001110000001
10111111111110001110000000001
10000001110000111000000000001
10000011100011111111111000001
10000000000000000000000000001
11111111111111111111111111111