NO ./assets/img/chiseled_tuff.png
SO ./assets/img/chiseled_tuff_bricks.png
WE ./assets/img/chiseled_tuff_top.png
EA ./assets/img/chiseled_tuff_bricks_top.png

F 20,22,25
C 13,14,15

1111111111111111111111 
1111111111111100111111 
1111111111111000111111 
1111111111110001111111 
1111111111100001111111 
1111111111100011111111 
1111111111101111111111 
1111110011101100011111 
1111000000100000001111 
1110000000000000000111 
1100000000000000000111 
1100000000000000001111 
1000000000000000011111 
1000000000000000011111 
1000000000000000011111 
1000000000000000011111 
1000000000000000001111 
1100000000000000001111 
1100000000000000000111 
1100000000000000000011 
1110000000000000000011 
1110000000000000000011 
1111000000000000000111 
1111100000000000001111 
1111100000111000011111 
1111110011111110111111 
1111111111111111111111
