NO ./assets/img/bricks.png
SO ./assets/img/bricks.png
WE ./assets/img/bricks.png
EA ./assets/img/bricks.png

F 0,0,0
C 0,0,0

11111111111111111111111111111111111111111111111111111111111111111111111111111111111111111111111111111111111111111111111111111111111111111111111111111111111111111111111111111111111111111111111 
10000000000000000000000000000000000000000000000000000000000000000000000000000000000000000000000000000000000000000000000000000000000000000000000000000000000000000000000000000000000000000000001 
10000000000000000000000000000000000000000000000000000000000000000000000000000000000000000000000000000000000000000000000000000000000000000000000000000000000000000000000000000000000000000000001 
1000000000000000000000000000000000000000000000000000000000000000000000000000000000000000000000000000000000000000000000000000000000000000000000000000000000000000000000000000000000000000000001 
10000000000000000000000000000000000000000000000000000000000000000000000000000000000000000000000000000000000000000000000000000000000000000000000000000000000000000000000000000000001000000000001 
10000000000000100000000000000000000000000000000000000000000000001111111001111000000000000000000000000011100001111000000000000000000000000000000000000000000000000000000011000000001000000000001 
10000000000000000000000000000000000000000000000000000000000000000000000000000000000000000001000000000000000000000000000000000000000000000000000000000000000000000000000111000000001000000000001 
10000000000000000000000000000000000000000000000000000000000000000000000000000000000000000000000000000000000000000000000000000000000000000000000000000000000000000000001111000000001000000000001 
10000000000000000000000000000000000000000000000000000000000000000000000000000000000000000000000000000000000000000000000000000000000000000000000000000000000000000000011111000000001000011100001 
10000000010011111000000000000000000000110000000011000000000001110000000000001000011000001001001000001000000000110000000100100000000000110010000000000001111000000000111111000000001000011100001 
10000000000000000000000000000001100000110000000011000000000000000000000000000000000000000000000000000000000000000000001100110000000001110011000000000000000000000001111111000000001000111110001 
10000000000000000000011000000001100000110000000011000000000000000000000000000000000000000000000000000000000000000000011100111000000011110011100000011000000000011011111111000000001000111110001 
10000E00000000000000011000000001100000110000000011000000000000000000000000000000000000000000000000000000000000000000111100111100000111110011110000011000000000011111111111000000001000111110001 
11111111111111111111111111111111111111111111111111111111001111111111100111111111111111111111111111111111111111111111111111111111111111110011111111111111111111111111111111111111111111111111111 
11111111111111111111111111111111111111111111111111111111111111111111111111111111111111111111111111111111111111111111111111111111111111111111111111111111111111111111111111111111111111111111111
