NO ./assets/img/bricks.png
SO ./assets/img/bricks.png
WE ./assets/img/bricks.png
EA ./assets/img/bricks.png

F 184,113,39
C 51,198,227

11111
10E01
10101
10G01
11111
