# Credits: https://gitlab.com/madebypixel02/cub3d

NO ./assets/img/diamond_ore.png
SO ./assets/img/lapis_ore.png
WE ./assets/img/redstone_ore.png
EA ./assets/img/coal_ore.png

F 184,113,39
C 51,198,227

11111111111111111111111111111
10000000001100000000000000001
11110000011100000001111111111
11111111110000000000000001111
11110000011100000000011111111
11111111100110000011101111001
11110111111111011100000010001
11110111111111011101010010001
11000000110101011100000010001
10000000000000001100000010001
10000000000000001100010000001
11000000110101000000000000001
11110111110101000000000000001
10000000001100000100000010001
10000000000000000000000001001
100000001111110010000N0000101
100000001   10011011111000011
10000000111111000001 10100001
11111111111111111111 11111111
