# Credits: https://git.narnaud.net/nicolas-arnaud/Cub3D

NO ./assets/img/bricks.png
SO ./assets/img/bricks.png
WE ./assets/img/bricks.png
EA ./assets/img/bricks.png

F 18 ,176, 12
C 27, 210, 227



                111111111111111111111111111111111111111111111111111111111111111111111111111111111111111111111111111111111111111111111111
              11100000000000000000000000000000000000000000000000000000000000000000000000000000000000000000000000000000000000000000000001
          111110000000000000000000000000000000000000000000000000000000000000000000000000000000000000000000000000000000000000000000000001
      1111100000000000000000000000000000000000000000000000000000000000000000000000000000000000000000000000000000000000000000000000000001
  11111000000000111111111111111111111111111111111111111111111111111111111111111111111111111111111111111111111111111111111111111111000001
  11100000000011111111111111111111111111111111111111111111111111111111111111111111111111111111111111111111111100000011111111111110000001
  10000000001111111111111111111111111111111111111111111111111111111111111111111111111111111111111111111111110000000000111111111000000011
  1000000000111111111111111111111111111111111111111111111111111111111111111111111111111111111111111111111100000111000001111111100000001
  1110000000001111111111111111111111111111111111111111111111111111111111111111111111111111111111111111111100000111100000111000000001111
  1111100000000011111111111111111111111111111111111111111111111111111111111111111111111111111111111111111100000111100000000000001111
  1111111000000000111111111111111111111111111111111111111111111111111111111111111111111111111111111111111111000001111000000000111
  11111111100000000011111111111111111111111111111111111111111111111111111111111111111111111111111111111111111100000111111111111
      11111000000000000000000000000000000000000000000000000000000000000000000000000000000000000000000000000000000001
          11111000000000000000000000000000000000000000000000000000W0000000000000000000000000000000000000000000000011
              11100000000000000000000000000000000000000000000000000000000000000000000000000000000000000000000000011
                11111111111111111111111111111111111111111111111111111111111111111111111111111111111111111111111111