NO ./assets/img/bricks.png
SO ./assets/img/bricks.png
WE ./assets/img/bricks.png
EA ./assets/img/bricks.png

F 184,113,39
C 51,198,227

1111111111111 
1110111110111 
1111011101111 
1110000000111 
1100100010011 
1000000000001 
1010000000101 
1010111110101 
1111001001111 
1111111111111
