NO ./assets/img/blackstone.png
SO ./assets/img/blackstone.png
WE ./assets/img/blackstone.png
EA ./assets/img/blackstone.png

C 225,30,0
F 220,100,0

111111
1G0001
100101
101001
1000N1
111111