C 0,0,0
F 0,0,0 

EA ./assets/img/coal_ore.png
NO ./assets/img/redstone_ore.png
SO ./assets/img/lapis_ore.png
WE ./assets/img/diamond_ore.png

1111111111111111
1000000000000001
1010111000011101
1000001011000001
1001100011011101
1001101000000101
10000011S1110001
1011101000010101
1010000011000101
1000110110010101
1010110000110101
1010000110100001
1010100010001001
1010111010011101
1000000000000001
1111111111111111
