NO ./assets/textures/walls/cherry_planks.png
SO ./assets/textures/walls/blackstone.png
WE ./assets/textures/walls/bamboo_block.png
EA ./assets/textures/walls/amethyst_block.png

F 184,113,39
C 51,198,227

11111111111111111111111111111
10000000000000000f0000000V0G1
100d0000001110000w01111111101
10000000111E000001110000111H1
10000011101110000a00001110001
10001110011100000e01110000001
101111111111100011100000B0001
100000K1110000111h00000000001
10000011100011111111111000001
10000000000000000000000000001
11111111111111111111111111111