EA ./assets/textures/walls/bubble_coral.png
NO ./assets/textures/walls/bubble_coral.png
SO ./assets/textures/walls/fire_coral.png
WE ./assets/textures/walls/fire_coral.png

F 1,1,1
C 1,1,1

111111111111111
111110000000111
111100000000011
111100001111011
111100010000001
111100010000001
10000001W000001
100100001111111
100100000000011
100100000000011
100100000000011
100100000000011
10G100000000011
111100011100011
111100011100011
111100011100011
111111111111111
