NO ./assets/textures/walls/chiseled_tuff.png
SO ./assets/textures/walls/chiseled_tuff_bricks.png
WE ./assets/textures/walls/chiseled_tuff_top.png
EA ./assets/textures/walls/chiseled_tuff_bricks_top.png

F 20,22,25
C 13,14,15

11111111
1000S001
10100101
10011001
10011001
101G0101
10000001
11111111
