# Credits: https://github.com/mcombeau/cub3D
NO ./assets/textures/walls/chiseled_tuff.png
SO ./assets/textures/walls/chiseled_tuff_bricks.png
WE ./assets/textures/walls/chiseled_tuff_top.png
EA ./assets/textures/walls/chiseled_tuff_bricks_top.png

C 35,19,73
F 15,6,40

111111111111111
1111110S0111111
111110000011111
111100000001111
111000010000111
110000111000011
100001111100001
110000111000011
111000010000111
111100000001111
111110000011111
1111110G0111111
111111111111111
