# Credits: https://gitlab.com/madebypixel02/cub3d

NO ./assets/textures/walls/bricks.png
SO ./assets/textures/walls/bricks.png
WE ./assets/textures/walls/bricks.png
EA ./assets/textures/walls/bricks.png

F 0,0,0
C 0,0,0

11111111111111111111111111111
10000000000000000000000000001
10000000000000000000000000001
10000000000000000000000G00001
10000000000000000000000000001
10000000000000000000000000001
10000000000000000000000000001
10000000000000000000000000001
10000000000000S00000000000001
10000000000000000000000000001
10000000000000000000000000001
10000000000000000000000000001
10000000000000000000000000001
10000000000000000000000000001
10000000000000000000000000001
10000000000000000000000000001
11111111111111111111111111111
