# Credits: https://gitlab.com/madebypixel02/cub3d

NO ./assets/textures/walls/cherry_planks.png
SO ./assets/textures/walls/cherry_planks.png
WE ./assets/textures/walls/bookshelf.png
EA ./assets/textures/walls/bookshelf.png

F 184,113,39
C 51,198,227

         111111111  111111111111111111
         100000001  100000000000000001
         10110000111100000001111111111
11111111110000000000000000011111
10000000111100010000N00001001
100000001  100110101110000001
1000000011111G000001 10100001
11111111111111111111 11111111
     
1111 111111111111111111111111
1111 100000000000000000000001
1111 111111111111111111111111
