NO ./assets/textures/walls/bricks.png
SO ./assets/textures/walls/bricks.png
WE ./assets/textures/walls/bricks.png
EA ./assets/textures/walls/bricks.png

F 184,113,-
C 51,198,227

11111
10E01
10101
10001
11111
