NO ./assets/textures/walls/blackstone.png
SO ./assets/textures/walls/blackstone.png
WE ./assets/textures/walls/blackstone.png
EA ./assets/textures/walls/blackstone.png

C 225,30,0
F 220,100,0

111111
100101
10100N
110001
111111