NO ./assets/img/cherry_planks.png
SO ./assets/img/structure_block_corner.png
WE ./assets/img/structure_block_load.png
EA ./assets/img/crafter_north.png

F 238,46,154
C 225,243,96

11111111111111111111111
11111111111111111111111
10000010000000001000001
10101010111011100011101
10101000100000101000101
10100111001110101110111
10100000001000100010001
10101111011011100000101
10100000001000001010101
10101110101111100010101
10101000000000000010101
11000010111111111011101
10000010000000001000101
10000010101111101110101
10000010100000000010001
10000010110111111011101
10000010000000001010001
10000011111101101010111
10000000000000001010001
10000011100011110011101
10000010000010000000001
10000010111110101101101
10101000000000100000101
11101011111010101111101
10001000000010101000101
10101011001011101010101
10101000001010000010101
10111011111010111010111
10100010001010100010001
10100110101010101111101
10001010100010001000101
10001000101011101010101
10001010001000001010001
10010011100111101011111
10001000100000000010001
11101010111100111010101
10001010000010N00000101
10011010111010100001111
10000000000010001010001
11111110010101111000101
10100010000000001000101
10101011111111101111101
10001000000000000000001
11111111111111111111111
