NO ./assets/img/horn_coral.png
SO ./assets/img/chiseled_tuff_bricks.png
WE ./assets/img/amethyst_block.png
EA ./assets/img/redstone_ore.png

F 199,67,49
C 95,215,235

111111111111111111111111111111111111111111111
110100000000000100000000010000000000000001011
110100111111011101100111001111010111100101011
110100010001000000010101000000010000000000011
110111000000011011010100111001010011110111011
110001010101000100010100000101010000010100011
110111000100010111110101011100010100000111011
110000010001000000000101000101000100000001011
110111110101000100011101110101001100001101111
110000000101000000000000000101000001000100011
11111100010100000000000001000111111E111101011
110000000000000000000100010000000000000000011
110111100101011110010001101011110111010111111
110000000101000001000100000000000000010000011
111110011101110111110111110111110101011111011
110000010000000000010100000000000000000000011
110111110011110101010100000000000000011111011
110100000100000001010000000000000000000100011
110101011000110110011101110100000000010101011
110001000000010100010001000000000000000001011
110101011111010100010111011110000000011101011
110000000001010000000100010000000000000001011
110111110101011110001100110100000000010111011
110100000101000100000001000100000000000100011
111101000100010101011111111001110001011001111
110001000101000100000000000001010100000001011
110111000001110111110111111101010111001111011
110100000001000000000000000000010000000100011
110111000110011101010011010110001100010101011
110000000000010001010001000001010000000001011
110111000111110101111001011101010110001011011
110001010000010100000001000100010100010000011
111101010111011111111111010111110101110111011
110001000001000000000000010000000100000100011
111111111111111111111111111111111111111111111
