NO ./assets/img/chiseled_tuff_bricks.png
SO ./assets/img/crafter_west.png
WE ./assets/img/crafter_north.png
EA ./assets/img/bricks.png

F 195,199,134
C 120,75,167

11111111
10000011
11111011
10000011
10111111
10000011
10011011
10001011
10011011
10100011
10101011
10101011
111W1111
10000011
10001011
10101011
10001011
10101011
10101011
10101011
10111011
10000011
11100011
10000011
11111111
