NO ./assets/img/cherry_planks.png
SO ./assets/img/chiseled_tuff.png
WE ./assets/img/bubble_coral.png
EA ./assets/img/chiseled_tuff_top.png

F 157,178,69
C 194,78,199

1111111111111111
1000001000000001
101110N100000001
1010000000000001
1110111000000001
1010000000000001
1010001100000001
1010100000000001
1010011010111111
1000100000100011
1010101110111011
1000001000000011
1111111111111111
1111111111111111
