NO ./assets/img/bookshelf.png
SO ./assets/img/fire_coral.png
WE ./assets/img/lapis_ore.png
EA ./assets/img/crafter_east.png

F 13,173,229
C 198,87,123

1111111111111111111
1111111111111111111
1100000000000100011
1101011111110101111
1100010100000100011
1101100101111101011
1101000001000001011
1101001111010101011
11010000000E0001011
1101110101111111011
1101000100000001011
1101000111010101011
1000000100000100011
1000000001010111011
1100010000010100011
1101010111000101111
1101010001000100011
1101011001011011011
1101000001000001011
1101110101110101111
1100010000000101011
1100010111101101011
1101000100000100011
1101011101110101111
1100000100010100011
1111110101010111011
1100000001000000011
1111111111111111111
1111111111111111111
