NO ./assets/img/coal_ore.png
SO ./assets/img/coal_ore.png
WE ./assets/img/chiseled_tuff.png
EA ./assets/img/diamond_ore.png

F 129,227,134
C 138,248,114

111111111111111111111111
110001000000000001000101
110100110111111100000001
1101000001S0000000000001
110110110110111111000001
110000010100000100010101
110111010101110101110101
110001000000010001000001
111111111111111111111111
