NO ./assets/img/chiseled_tuff.png
SO ./assets/img/chiseled_tuff_bricks.png
WE ./assets/img/chiseled_tuff_bricks.png
EA ./assets/img/coal_ore.png

F 29,245,61
C 77,180,181

11111111111111111111111111
11111111111111111100011111
10100000000000000000000011
10101101111101001000001011
10001000000000000000001011
10111011111011000000011011
10001000001010000000001011
11101111100010000000001011
10000000001010000000000011
10011010001110000000011111
10101010100000100010000011
10101000001111101111101011
10001000100000100000000011
11110011110110101001111111
10000000000000001000001011
10000000000000001110101011
10000000000000000010001011
10000000000000011010111011
10000000000000001000100011
10000000000000001101101011
10000000000000000000001011
10000000000000010011111111
10000000000000000000000011
10000000000000011111111011
10000000000000000000001011
10000000000000011110111011
10000000000000000010001011
10000000001010111010101011
10001010001010001000100011
10100011111111101001111011
10000010000000101000100011
11101010101000101011101111
10001000000000101000000011
101011W1100011101101111011
10000000101000000000001011
10111110101111111111101011
10000010000000000000001011
11111111111111111111111111
11111111111111111111111111
