NO ./assets/img/bamboo_planks.png
SO ./assets/img/fire_coral.png
WE ./assets/img/blackstone.png
EA ./assets/img/chiseled_tuff_top.png

F 186,255,16
C 208,81,216

111111111
111111001
110001001
110100001
110100001
110100001
110000011
110100011
110100011
110100011
110001011
110101011
110001011
111101011
110001011
110111011
110001011
111111011
110000011
111111111
