NO ./assets/img/horn_coral.png
SO ./assets/img/structure_block.png
WE ./assets/img/chiseled_tuff_top.png
EA ./assets/img/chiseled_tuff_bricks_top.png

F 225,51,92
C 171,116,254

111111111111111111111111111111111111111
100000001000000000000000100000100000001
101110110001110100111000110010101111101
101000100010001000000010001000001010001
100011100110111010111011101100111000111
101000001000001010001000100010000000001
101000111111100011001110111010101011101
100000000000100010000010000010000000101
100111010000000010111010101011111111101
101000100000001010001010000000000010001
110010111011101011000010100010101010101
10N010000000000010001010001010001000101
100110000000000110100101101011111111101
101000000000000000101000101000100000001
100000000000000111111010100010100111111
101010000000000000000000001000001010001
100010000000000000101011111010011010101
101000000000000010100000001000100000101
111010000000000010111111101110111111101
100000000000000010000000001000000000001
111111111111111111111111111111111111111
