NO ./assets/img/bamboo_block.png
SO ./assets/img/crafter_west.png
WE ./assets/img/blackstone.png
EA ./assets/img/bubble_coral.png

F 56,74,161
C 38,137,90

1111111111111111111111111111111111111
1100010000000000000000000100000100011
1101010011011111111111110100000111011
1101010000010000000000000000000000011
1101010101011111011011111111111111111
1101000101010001000000000000000100011
1101000000000000000000001110110101111
1101000000000000000000010000010001011
1101000000000000000000000001000111011
1101000000000000000000010101000001011
1101000000000000000000000101010001011
1100000000000000000000010101010101011
1101000000000000000000010101010101011
1100000000000000000000000101000100011
1111000000000000000000011101111111111
1101000000000000000000000100000000011
1100000000000000000000010101111111011
1100000000000000000000000100000100011
110100000000000000000001000E111101111
1101000100000000000000000000000000011
1101110001101111010001100111010101011
1100010000000001010000010000000000011
1101101111010011010111111101011111011
1100000000010100010100000000010100011
1111010111110101110101110101010101111
1100010100000100010001000100000100011
1101010101100111000101010110110101011
1100000100000001010000000000010001011
1101010001110101000111111111000011011
1101000001000000010101000000010100011
1101110111010110010100011101011101111
1101000100010000010001010001000001011
1101010101111111111101010101011111011
1100010100000000000001000100000000011
1111111111111111111111111111111111111
