NO ./assets/img/redstone_ore.png
SO ./assets/img/bubble_coral.png
WE ./assets/img/crafter_north.png
EA ./assets/img/bamboo_block.png

F 90,50,113
C 61,68,131

1111111111111111111111111111
1111111111111111111111111111
1000100000000000100000000011
1011101011111110101010001001
1000001010000010100000100001
1010111010101110111011011001
1000100010100000001010000001
1111001110111111001110111001
1000001000000010000000100001
1001100010100011111111101001
1000000000001000000000001001
10101W1011100111111010111001
1010001000000000000000000001
1000000000111110111110111001
1000000000100000000000001001
1100000000101111101001111001
1000000000101000001000000011
1000000000101010101111111111
1000000000001010001000000011
1000000000111001110110101011
1000000000000010000000001011
1000000000101101001110111111
1000000000001000100010000011
1000000000101010111010101011
1010101000100010100010001011
1000111010111110101011101011
1000000010001000001000001011
1011001111101111011110101011
1000100010101000100000001011
1110101010101010111111111011
1000001000100010000000000011
1111111111111111111111111111
