NO ./assets/img/brain_coral.png
SO ./assets/img/bamboo_door_bottom.png
WE ./assets/img/horn_coral.png
EA ./assets/img/chiseled_tuff_bricks_top.png

F 222,247,244
C 122,124,80

1111111111111
1111111111111
1100000000011
1101111111011
1100000100011
1111010101011
1100000101011
1101000000011
1101000000011
1101000000011
1100000000011
1101010111011
1100010100011
1100100101111
1101010001011
1101000111011
1101000000011
1101111011011
1100010001011
1101010001011
1100010101001
1111010111001
1100010001011
1101010101011
1100010000011
1100001001111
1100000000011
1000000111011
1000000101011
1000000101011
1000000001011
1101101101011
1100000101011
1111110101011
1100000100011
1101111101111
1101000000011
1101110011111
1100000000011
1101011111011
1100010001011
11011N0111011
1101000001011
1101111101011
1100000001011
1111111111111
1111111111111
