NO ./assets/textures/walls/cherry_planks.png
SO ./assets/textures/walls/cherry_planks.png
WE ./assets/textures/walls/cherry_planks.png
EA ./assets/textures/walls/cherry_planks.png

> You wake up.
> But you realize that something is wrong.
> You look around and realize - someone was here.
> They stole all of the stars out of the night sky, and your coding AI bot girlfriend.
> Time to get your revenge, and those 8 stars back.

F 65,152,10
C 135,206,235

1111111111111111111111
111111111111110G111111
1111111111111000111111
1111111111110001111111
1111111111100001111111
1111111111100011111111
1111111111101111111111
11111100111h1100011111
1111000000100000001111
1110000000000000000111
1100000000000000000111
1100000000000000001111
1000000000000000011111
1000000000000000011111
1e00000000000000011111
1000000000000000011111
1000000000000000001111
1100000000000000001111
1100000000000000000111
1100000000000000000011
1110000000000000000011
1110000000000000000011
1111000000000000000111
11111000000N0000001111
1111100000111000011111
1111110011111110111111
1111111111111111111111
