NO ./assets/textures/walls/crafter_south.png
SO ./assets/textures/walls/crafter_south.png
WE ./assets/textures/walls/crafter_south_triggered.png
EA ./assets/textures/walls/crafter_south_triggered.png

F 56,56,56
C 0,189,176

> As you try to leave the fighting dojo, the floor opens up beneath you.
> You now have to fight for real in a coloseum, for the amusement of your captivator.
> He promises you a star if you win.

111111111111111
1111100w0011111
111000000000111
110000000000011
1000000S0000001
100000000000001
1e00000000000f1
100000000000001
1000000r0000001
110000000000011
111000000000111
1111100a0011111
111111101111111
111110000011111
111000000000111
110000000000011
100000000000001
100000000000001
1e00000000000f1
100000000000001
1000d00i00s0001
110000000000011
111000000000111
111110000011111
1111111H1111111
111000000000111
110000000000011
1h00000000000G1
110000000000011
111000000000111
111111111111111