NO ./assets/textures/walls/bricks.png
SO ./assets/textures/walls/bricks.png
WE ./assets/textures/walls/bricks.png
EA ./assets/textures/walls/bricks.png

F 0,64,59
C 135,206,235

         1111111111111111111111111111
         100000000K110000000EVVV0000G1
         1011111111110000000111111111
         1000000000V00000001K1
        1011000001110000000001
11111111100110000011101111111
1K0001K00000010101000000100K1
11110111111101H10101h10010001
1100000011010101h100000010001
1000d000000000001100000011H11
10000000000000001100010010001
110000001101H1111100000011101
1111H111K00101000000s00000001
1h100001111100000100000010001
10100000000000001100000001001
1000000011110001K100000001001
111110001K0100110101110111101
1h000000100000000001 10VKKV01
11111111111111111111 11111111