NO ./assets/textures/walls/bookshelf_1.png
SO ./assets/textures/walls/bookshelf_1.png
WE ./assets/textures/walls/bookshelf.png
EA ./assets/textures/walls/bookshelf.png

F 0,64,59
C 135,206,235

> As you start reaching deeper into the north, you find a world left behind.
> What once was the beautiful library of cubandria is now forgotten and left to rot.
> Everything is crawling with monsters, and locked doors make it hard to progress further.

         1111111111111111111111111111
         100000000K110000000EVVV0000G1
         1011111111110000000111111111
         1000s00000V00000001K1
        1011000001110000000rd1
11111111100110000011101111111
1K0001K00000010101000000100K1
11110111111101H10101h10010001
1100000011010101h100000010001
1000d000000000001100000011H11
10000000000000001100010010001
110000001101H1111100000011101
1111H111K00101000000s00000001
1h100001111100000100000010001
1010000000000000110a000001001
1000q00011110001K10000d001001
111110001K01001101011101111H1
1h000000100000000001 10VK0p01
11111111111111111111 11111111