NO ./assets/textures/walls/bookshelf_1.png
SO ./assets/textures/walls/bookshelf_1.png
WE ./assets/textures/walls/bookshelf.png
EA ./assets/textures/walls/bookshelf.png

F 0,64,59
C 135,206,235

FO 75,0,0,0
MM OFF

> ----- DAEDALUS'S MAZE -----
> As you start reaching deeper into the north, you find a world left behind.
> What once was the beautiful library of cubandria is now forgotten and left to rot.
> Everything is crawling with monsters, and locked doors make it hard to progress further.

         11111111111111111111111111111
         100000d000eK10000000EVVVVV00G1
         10011111111100000001111111111
         110000000sV00000001K1
        10h1000001110000000sr1
111111111011100000111H111111111111
1K0001K00000010101000q0e10000000001
11110111111101010101h100100i00d01Kh1
1100000f11010101h100000010000000001
10h1d000000000001100000111H1111111
10110000000u00001100001h10001
100000001101H1111100001011101
1111H111K00101w0000000000q001
1h100001111100000100000010111
10100s0000000000110a000010001
1000q00011110001h10000o0011H1
11111001K001001101011101111r1
1h0000010r0V00000000h101K0p01
11111111111111111111111111111