NO ./assets/textures/walls/bookshelf_1.png
SO ./assets/textures/walls/bookshelf_1.png
WE ./assets/textures/walls/bookshelf.png
EA ./assets/textures/walls/bookshelf.png

F 0,64,59
C 135,206,235

> ----- DAEDALUS'S MAZE -----
> As you start reaching deeper into the north, you find a world left behind.
> What once was the beautiful library of cubandria is now forgotten and left to rot.
> Everything is crawling with monsters, and locked doors make it hard to progress further.

         1111111111111111111111111111
         10000q000K110000000EVVVV000G1
         1011111111110000000111111111
         1000s00000V00000001K1
        1011000001110000000rd1
1111111110011000001110111111111111
1K0001K0000001010100000010000000001
11110111111101H10101h100100i00001K1
1100000011010101h100000010000000001
1000d000000000001100000011H1111111
10000000000i00001100010010001
110000001101H1111100000011101
1111H111K00101000000s00000001
1h100001111100000100000010111
10100o0000000000110a000010001
1000q00011110001K10000d001001
111110001K01001101011101111H1
1h000000100000000001 10VK0p01
11111111111111111111 11111111