NO ./assets/textures/walls/bookshelf_1.png
SO ./assets/textures/walls/bookshelf_1.png
WE ./assets/textures/walls/bookshelf.png
EA ./assets/textures/walls/bookshelf.png

F 0,64,59
C 135,206,235

> ----- ELEMENTOR'S DOMAIN -----
> Only one star left to go before you can return.
> Wait, who is that back there?
> Be careful.

  11111111111
  10000S00001
  10000000001
  10e00000f01
  10e00000f01
  10a00000w01
  10a00000w01
  10000000001
  10000K00001
  1h0000000h1
1111111H1111111
1h00000000000h1
100000000000001
100000000000001
100000000000001
100000000000001
100000000000001
1000000B0000001
100000000000001
100000000000001
100000000000001
100000000000001
100000000000001
1h00000000000h1
1111111H1111111
  1h0000000h1
  10000000001
  10h00000h01
  10h00000h01
  10h00000h01
  10h00000h01
  10000000001
  1h0000000h1
  11111111111