NO ./assets/textures/walls/brain_coral.png
SO ./assets/textures/walls/bubble_coral.png
WE ./assets/textures/walls/fire_coral.png
EA ./assets/textures/walls/horn_coral.png

F 1,29,52
C 1,114,116

FO 100,52,97,219
MM OFF

> ----- THE SUNKEN TREASURE -----
> You know that you are close to a confrontation.
> Unsure about whether you have enough ammo and health, you desperately decide to follow a local fairytale.
> Apparently, a sunken treasure has been lost not too far from the local shore.
> You jump into the cold water and dive down.

11111111111111111111111111111
11000000010000000000010000011
11010011010111111111010000001
11010101000100000001000000001
11010101011101111101101111011
1101010000000100K101010000011
11010111000111001101010111111
11010100000101000101010100011
11110101110101010101010001011
11000100010100010001000001S11
11011100000001110100111111H11
1100011111100000010001hhhha11
11110100001001110111010000w11
11000100000000010000010000f11
1101011111010101110111000ea11
11h10100010001h0010001fffff11
1101110101011111011101wwwww11
110100000101000000a101eeeee11
1101011101010101011101aaaaa11
1100000100000101000f01hhhhh11
11111111111111111111111111111