NO ./assets/textures/walls/brain_coral.png
SO ./assets/textures/walls/bubble_coral.png
WE ./assets/textures/walls/fire_coral.png
EA ./assets/textures/walls/horn_coral.png

F 32,64,150
C 32,64,150

FO 200,32,64,150
MM OFF

> ----- THE SUNKEN TREASURE -----
> You know that you are close to a confrontation.
> Unsure about whether you have enough ammo and health, you desperately decide to follow a local fairytale.
> Apparently, a sunken treasure has been lost not too far from the local shore.
> You jump into the cold water and dive down.
> You can always return if you can't find the key, press ESC to restart the level.

11111111111111111111111111111
11000000010000000000010000011
110100110101111111110100q0001
1101q101000100000001000000001
11010101011101111101101111011
1101010000000100K101e10000011
110101110001110011010101111G1
11010100000101000101010100001
11110101110101010101010000011
11000100010100010001000001S11
11011100000001110100111111H11
1100011111100000010001hhhha11
1111010000100111011101hhh0w11
110001000000000100q001hh00f11
1101011111010101110111h00ea11
11h1e100010001h00100010f0f011
1101110101011111011101w0w0w11
110100q0010100000001010e0e011
1101011101010101011101a0a0a11
11000001000001e1000001hhhhh11
11111111111111111111111111111