NO ./assets/textures/walls/amethyst_block.png
SO ./assets/textures/walls/amethyst_block.png
WE ./assets/textures/walls/amethyst_block.png
EA ./assets/textures/walls/amethyst_block.png

F 58,36,92
C 255,224,242

FO 50,50,0,50

> ----- ELEMENTOR'S DOMAIN -----
> Only one star left to go before you can return.
> Wait, who is that back there?
> Be careful.

    11111111111
    1e1hhhhh1f1
    1e1000001f1
    1w100N001a1
    1w1000001a1
    10000000001
    10000000001
    10000000001
    10111H11101
    10hh101Kh01
  111111101111111
  1h00000000000h1
  100000000000001
  100000000000001
  100000000000001
  100000000000001
 11000000000000011
1h0000000B0000000h1
 11000000000000011
  100000000000001
  100000000000001
  100000000000001
  100000000000001
  1h00000000000h1
  111111101111111
    1hhh1h1hhh1
    10001H10001
    10000000001
    10h00000h01
    10h00h00h01
    10h00h00h01
    10h00000h01
    100h000h001
    1h000G000h1
    11111111111
