NO ./assets/textures/walls/amethyst_block.png
SO ./assets/textures/walls/amethyst_block.png
WE ./assets/textures/walls/amethyst_block.png
EA ./assets/textures/walls/amethyst_block.png

F 58,36,92
C 255,224,242

FO 50,50,0,50

> ----- ELEMENTOR'S DOMAIN -----
> Only one star left to go before you can return.
> Wait, who is that back there?
> Be careful.

    11111111111
    10000S00001
    10e00000f01
    10e00000f01
    10000000001
    10a00000w01
    10a00000w01
    10000000001
    10001110001
    10001h10001
  111100101001111
  1h00000000000h1
  100000000000001
  100000000000001
  100000000000001
  100000000000001
 11000000000000011
1h0000000B0000000h1
 11000000000000011
  100000000000001
  100000000000001
  100000000000001
  100000000000001
  1h00000000000h1
  111111101111111
    1hhh1h1hhh1
    10001H10001
    10000000001
    10h00000h01
    10h00h00h01
    10h00h00h01
    10h00000h01
    100h000h001
    1h000G000h1
    11111111111
