NO ./assets/img/blackstone.png
SO ./assets/img/blackstone.png
WE ./assets/img/blackstone.png
EA ./assets/img/blackstone.png
F 199,3,1
C 1,1,1
111111111111111111111
100000000010000000001
101111111010111111101
100S00001010100000001
111110111010101111111
100000100010100000001
101111101010111111101
100010101010100000001
111010101110101111111
101000100010100000001
101110111000111111101
100010101000100000001
101010101011101111111
101010001000100000101
101011101110111110101
101000100010000010001
101011111011111011101
101010001000001000001
101010101111101111111
101000100000000000001
111111111111111111111
