NO ./assets/img/bricks.png
SO ./assets/img/bricks.png
WE ./assets/img/bricks.png
EA ./assets/img/bricks.png

F 184,22,39
C 257,198,227

11111
10E01
10101
10001
11111
