# Credits: https://gitlab.com/madebypixel02/cub3d

NO ./assets/img/structure_block_corner.png
SO ./assets/img/structure_block_data.png
WE ./assets/img/structure_block_load.png
EA ./assets/img/structure_block.png

F 184,113,39
C 51,198,227

11111111111111111111111111111
100000000011000000000E0000001
10110000011100000000000010001
10010000000000000000000010001
1011000001110000S000000010001
10000000001100000111011110001
11110111111111011100000010001
11110111111111011101010010001
11000000110101011100E00010001
1000000E000000001100000010001
10000000000000001100010000001
11000000110101000000000000001
111101111101010000000W0000001
10000000001100000100000010001
1000000000000000000000S001001
10W00000001000010000N00001001
10000000001101000000000000001
10000000000100000001010000001
11111111111111111111111111111
